114
8
21 21 2 0 0 3 22 22 22 22 22 22 22 22 4 0 0 0 0 0 3 22 22 22 22 4 0 0 0 0 0 0 0 0 0 0 3 22 22 22 22 4 0 0 0 0 0 0 0 0 0 0 0 0 0 0 0 0 0 0 0 0 3 22 22 22 22 22 22 22 22 0 0 3 22 22 22 22 22 22 22 4 0 0 0 0 0 0 0 0 0 0 3 22 22 22 22 22 22 22 22 22 22 22 22 22 22 22 22 22 22 22 22 22 
22 22 4 0 0 3 22 22 22 22 22 22 22 22 4 0 0 0 0 0 0 18 22 22 22 4 0 0 0 0 0 0 0 0 0 0 3 22 22 22 22 4 0 0 0 0 0 0 0 10 10 0 0 0 0 0 0 0 0 0 0 0 0 18 22 22 22 22 22 22 19 0 0 0 18 22 22 22 22 19 17 0 0 0 9 0 0 0 0 9 0 0 0 18 22 22 22 19 17 17 17 17 17 17 17 17 17 17 17 17 17 17 18 22 
22 22 4 0 0 3 22 22 22 22 22 22 22 22 4 0 0 0 9 9 0 0 18 22 19 0 0 0 0 0 0 0 0 0 0 0 0 18 22 19 17 0 0 0 0 0 0 11 1 21 21 2 9 11 9 0 0 0 0 0 0 0 0 0 18 22 22 22 22 19 0 0 0 0 0 17 17 17 17 0 0 0 0 1 21 2 10 10 1 21 2 0 0 0 18 22 19 0 0 9 0 0 0 0 0 0 0 0 0 0 0 0 3 22 
22 22 4 0 0 0 17 17 17 17 17 17 17 17 0 0 0 1 21 21 2 0 3 22 4 0 0 0 0 0 9 9 0 0 0 0 0 0 17 0 0 0 0 0 0 0 1 21 21 6 5 21 21 21 21 21 2 0 0 0 0 0 0 0 0 18 22 22 19 0 0 0 0 0 0 0 0 0 0 0 0 0 1 21 7 21 21 21 21 6 4 0 0 0 0 17 0 0 1 21 2 0 0 0 0 0 0 0 0 0 0 0 3 22 
22 22 4 0 0 0 0 0 0 0 0 0 0 0 0 0 0 3 22 22 4 0 0 17 0 0 0 0 0 1 21 21 2 0 0 0 0 0 0 0 0 0 0 0 9 1 21 6 19 17 17 17 17 17 17 17 0 0 0 0 0 0 0 0 0 0 17 17 0 0 0 0 0 0 0 0 0 0 0 0 0 0 0 17 17 17 17 17 17 17 0 0 0 0 0 0 0 1 21 6 4 0 9 10 11 0 0 0 10 11 9 0 3 22 
22 22 4 11 0 9 10 9 0 11 0 9 10 9 0 11 1 21 6 22 4 0 0 0 0 0 0 0 1 21 6 22 4 11 0 0 0 0 0 0 0 0 0 1 21 21 6 19 0 12 11 0 0 12 0 0 11 0 0 0 0 0 0 0 0 0 0 0 0 0 0 0 0 0 0 0 0 1 21 2 0 0 0 0 11 0 0 0 0 0 11 0 0 0 0 0 1 21 6 22 4 0 23 24 25 0 0 0 23 24 25 0 3 22 
22 5 21 21 21 21 21 21 21 21 21 21 21 21 21 21 21 6 22 22 4 0 10 10 0 0 0 1 21 6 22 5 21 21 2 0 0 0 0 0 11 10 1 21 6 22 19 9 11 1 21 2 10 10 10 1 21 2 0 0 0 0 11 10 11 0 0 0 0 9 9 0 0 0 0 0 1 21 6 4 0 0 0 1 21 2 9 11 10 1 21 2 0 0 0 1 21 6 22 22 4 11 10 10 11 9 10 9 11 10 9 11 3 22 
22 22 22 22 22 22 22 22 22 22 22 22 22 22 22 22 22 22 22 22 4 1 21 21 2 0 0 3 22 22 22 22 22 22 4 0 0 0 0 1 21 21 21 6 22 5 21 21 21 21 7 21 21 21 21 21 6 4 0 0 0 1 21 21 21 2 0 0 1 21 21 2 0 0 0 1 21 6 22 4 0 0 1 21 7 21 21 21 21 21 6 4 0 0 1 21 6 22 22 5 21 21 21 21 21 21 21 21 21 21 21 21 21 6 
