85
8
21 2 0 0 0 0 0 0 0 0 0 0 0 0 0 0 0 0 0 0 0 0 3 22 22 22 22 22 22 22 4 0 0 0 0 0 3 22 22 22 22 22 22 22 22 22 22 22 4 0 0 0 0 3 22 22 22 22 22 22 22 22 22 22 4 0 0 0 0 0 0 3 22 22 22 22 22 22 22 22 22 22 22 22 22 
22 4 0 0 0 0 0 0 0 0 0 0 0 0 0 0 0 0 0 0 0 0 0 17 18 22 22 22 22 22 4 0 0 0 0 0 3 22 22 22 22 22 22 22 22 22 22 22 4 0 0 0 0 0 17 17 17 17 17 17 17 17 17 17 0 0 0 0 0 0 0 0 17 17 17 17 17 17 17 17 17 17 17 18 22 
22 4 0 0 0 0 0 0 0 0 0 0 0 0 0 0 0 0 0 0 0 0 0 0 0 17 18 22 22 19 0 0 0 0 0 0 0 17 17 17 17 17 17 17 17 17 17 17 0 0 0 0 0 0 0 0 0 0 0 0 0 0 0 0 0 0 0 0 0 0 0 0 11 0 0 0 0 0 0 0 0 0 0 3 22 
22 4 0 0 0 0 9 9 0 0 9 11 0 0 0 0 11 9 0 0 10 0 9 0 0 0 0 17 17 0 0 0 0 0 0 0 0 0 0 0 0 0 0 0 0 0 0 0 0 11 9 0 0 0 0 0 0 0 0 0 9 10 9 0 0 0 0 0 0 10 10 1 21 2 0 0 0 0 0 0 0 0 0 3 22 
22 4 0 0 0 0 23 25 0 1 21 21 2 0 0 1 21 21 2 0 23 24 25 0 0 0 0 0 0 0 0 0 0 0 0 0 0 0 0 0 11 10 0 0 0 0 0 0 1 21 21 2 0 0 0 0 0 0 0 0 23 24 25 0 0 0 0 0 0 23 25 3 22 4 0 0 0 0 0 0 0 0 0 3 22 
22 4 11 0 10 0 9 0 10 3 22 22 4 9 10 3 22 22 4 0 0 0 0 0 0 10 11 0 0 9 0 10 0 0 10 9 0 0 0 1 21 21 2 9 10 0 11 9 3 22 22 4 0 0 10 9 0 0 0 0 0 0 0 0 11 9 0 0 0 0 0 3 22 4 0 0 0 0 0 0 0 0 0 3 22 
5 21 21 21 21 21 21 21 21 21 6 5 21 21 21 21 6 5 21 2 0 0 0 0 0 23 25 0 0 23 24 25 0 0 23 25 0 0 1 21 22 5 21 21 21 21 21 21 21 22 22 4 0 0 23 25 0 0 0 0 0 0 0 0 23 25 0 0 0 0 0 3 22 4 9 10 10 11 11 10 10 9 9 3 22 
22 22 22 22 22 22 22 22 22 22 22 22 22 22 22 22 22 22 22 4 0 0 0 0 0 0 0 0 0 0 0 0 0 0 0 0 0 0 3 22 22 22 22 22 22 22 22 22 22 22 22 4 0 0 0 0 0 0 0 0 0 0 0 0 0 0 0 0 0 0 0 3 5 21 21 21 21 21 21 21 21 21 21 21 6 
